.....########...
....#...........
...#..######....
..#..#......#...
.#..#...##...#..
.#..#..#L.#...#.
.#...#....#...#.
..#...####...#..
...#........#...
....########....
................